%%%%%%%%%%
%       P%
%     %% %
%     %% %
%        %
%      N %
%   %%   %
%   %%   %
%        %
%%%%%%%%%%