%%%%%%%%%%%%%%%%%%%%%%%%%%%%%%%%%%%%%%%%%%%%%%%%%%%%%%%%%%%%%
%     %       %             %         %     %           %   %
%%% %%% %%%%%   %%%%% %%%%% %%% %%%%%%% % %%% %%%%%%%%%%% %%%
%   %   %     %   % %   % %   %         %          % % %    %
% %%% %%% %%% %%% % %%% % %%% % %%%%%% %%%%% %%%%% % % %%%% %
% %   % %   % %   %   % % % % %     %        %   % % %      %
%   %%% % % % % % % % %%% % % % %%% % %%%% % %%% % % %% % % %
% %   %   % %   %   % %   % %     % % %  % %     % %  %%% % %
% %%%%%%% % % %%% %%% %%%   %%% %%% % % %% %%%%% %%%% % % % %
%   %   % %       % % %   % % %  %  % %  %    %     %   % % %
% % %%% % %%%%%%%%% % % %%% % %  % %% %% % %%%%%%%%%%% %%%% %
% %   % %   %       %%% %     %  %    %  %      %           %
% % %%% %%%%% %%%%%   % %%%%%%%% %%% %%% % %% %%% %%%%%%% % %
% %   %%      %     %   %        %     % %  %   %     %   % %
% %%%%% % %%%%% %%%%% % %%%%% %%%%%%%%%% % %%%%%% %%% %%% % %
% % % % % %     %   % %             %    %    %   %     % % %
%   %%% %%% %%%%%%% %%%%% %%%%%%% %%% %% %%%  % %%% %%% %%% %
% %       %       % %     %            %   %    %     %   % %
% %%%%% % %%%%%%% %%%%%%% %%%%%%%% %%% % %%%%%% % % %%%%% % %
%.%     %   %     %       %   %    %   %        % % %   % % %
%%%%%% %% % % %%%%% %%%%% %%% % %%%% %%%%%%%%%%%%%%%% %%% % %
%P        % %           %     %           %           %     %
%%%%%%%%%%%%%%%%%%%%%%%%%%%%%%%%%%%%%%%%%%%%%%%%%%%%%%%%%%%%%
